...............
..xx...........
..xx.......xx..
..xx.......xx..
...............
.......xxxx....
.......xxxx....
...............
...............