xxxxxxxxxxxxxxxxxxxxxxxx
x......................x
x......................x
x.....x......xxxxxxx...x
x.....x............x...x
x.....x............x...x
x.....x...x...xxxxxx...x
x.....x...x...x........x
x.....xxxxxx..x........x
x.........x...xxxxxx...x
x......................x
x......................x
xxxxxxxxxxxxxxxxxxxxxxxx