...............
..XX...........
..XX.......XX..
..XX.......XX..
...............
.......XXXX....
.......XXXX....
...............
...............