XXXXXXXXXXXXXXXXXXXXXXXX
X......................X
X......................X
X.....X......XXXXXXX...X
X.....X............X...X
X.....X............X...X
X.....X...X...XXXXXX...X
X.....X...X...X........X
X.....XXXXXX..X........X
X.........X...XXXXXX...X
X......................X
X......................X
XXXXXXXXXXXXXXXXXXXXXXXX